R 1920 1080     
SO text/greystone.xpm
WE text/red.xpm
EA text/purplestone.xpm

S text/tonneau.xpm
NO text/eagle.xpm
F 0  ,100,  0  
C 225,   30,0

        1111111111111111111111111
       1100000110000000000000111111
       100000001110000000000111111
       1101000000000000002000001111111
11111111101100000111000000000000000011
10000000001110000011101111111111111111
11110111111 11101110000001001
11110111111 11101110000001001
11110111111111011121010010001
11000001101010111000000100011 
10000000000000001100000010001  
11200000000020000110101000001 
1000000111001011111011110N01111
11110111 100101 101111010001
11111111 111111 111111111111
