R 1920 1080
NO text/mossy.xpm
WE text/red.xpm
EA text/wood.xpm

SO ../text/greystone.xpm

S text/tonneau.xpm    
F 0,0,0
C 225,  225, 225

1111111111111111111111111
1000000000000000000000001
1000000000000000000200001
1000200000000000000000001
1000020000000000000000001
1000000000111000000000001
10000200001 1000000000001
1000000000111000000000001 
100002020000000000S000001
1000000000000000000000001
1002020002220000000000001 
1000000020000000000000001
1111111111111111111111111
