NO text/red.xpm
R 11111111 2147483647
 
EA text/wood.xpm
WE text/red.xpm

SO ./text/greystone.xpm

S  ./text/tonneau.xpm    
F 255,0,    255
C 225,  225, 225

11111111111111111111111111111111111111111111
  1  100000000000000000000000000000000000001
11111100000000000000000000000000000000111111
100000000000000000000000000000000000001
100000002000000000000000000000000000001
10000000000000000000S000000000000000001
100000000000000000000000000000000000001
100000000000000000020002000000000000001
111000000000000000000000000000000000001
100000000000000000000020000000000001111
111000000000000000000000000000000000001
100000002000000000000000000000000000001
100000000000000000000000000000000000001
100000000000000000000000000000000000001
100000000000000000000000000000000000001111
100000000000000000000000000000000000000001 
111111111111111111111111111111111111111110
